#map
0,0,0,0,0,0,0,0
0,0,0,0,0,0,0,0
0,0,0,0,0,0,0,0
1,2,3,0,9,10,11,12
0,0,4,0,8,0,0,0
0,0,5,6,7,0,0,0
0,0,0,0,0,0,0,0
0,0,0,0,0,0,0,0
#levels
e,60,e,60,e
e,20,e,60,e
e,10,e,10,e,10,e,10,e,10
